15 15
2 0
9 12
SSS**SSSSSSSS**
S****S**S*S*S*S
SSSSSS*SS*S*S*S
S****SS***SSSSS
S*SS**S*SSS***S
S**SSSS*S**SSSS
S*******S*SS**S
SSSSS*S*S*S***S
S***SSSSS*SS**S
SSS*******S*S*S
S*S*S*SSSSS*S*S
S*SSSSS*****S*S
S******SSSSSS*S
SSSSSS*S******S
S******SSSSSSSS